users	passwords
VPGR	BXOO
NLCG	OIMM
WNIB	TPGK
XJOR	JJTE
MNDY	JAIK
KPHZ	ATKT
YDLV	BBXN
PJBX	KWMB
DGYJ	ZXTE
YNHN	WQFP
XUNY	HLRW
ZXCD	DFMA
FHDU	IMDP
EFLE	HBNC
UDXX	MRPD
RJKP	AWCW
SYFD	LRHA
TQYC	DIUZ
DDOI	WWXB
VCOW	EMAU
ALUT	QHWR
CQNU	SUJK
TCQV	MYGB
WNDX	TVFE
BDUT	WYQM
YKUE	RUXF
HVKN	EDKM
OXXN	HCXU
GXHE	VTXP
RXMY	CKRU
WEVQ	GAKX
